#######################################
# Syntax Coloring Map Data
#######################################

#######################################
# Datatypes (KEYWORD1)
#######################################

Data	KEYWORD1
Timer	KEYWORD1
Series	KEYWORD1
Measurement	KEYWORD1
Sensor	KEYWORD1
VoltageSensor	KEYWORD1
TemperatureSensor	KEYWORD1
HallEffectSensor	KEYWORD1
WheelSensor	KEYWORD1
PhotoSensor	KEYWORD1
SwitchSensor	KEYWORD1
Actuator	KEYWORD1
MotorActuator	KEYWORD1

#######################################
# Methods and Functions (KEYWORD2)
#######################################
print	KEYWORD2
println	KEYWORD2
freeze	KEYWORD2
beginSerial	KEYWORD2
beginTimer	KEYWORD2
currentTime	KEYWORD2
timePrint	KEYWORD2
timePrintln	KEYWORD2
floatPrint	KEYWORD2
floatPrintln	KEYWORD2
startBluetooth	KEYWORD2
stopBluetooth	KEYWORD2
debugBluetooth	KEYWORD2
beginSD	KEYWORD2

floatToString	KEYWORD2
dataLine	KEYWORD2
millisToSeconds	KEYWORD2
secondsToMillis	KEYWORD2
scale	KEYWORD2

timer	KEYWORD2
duration	KEYWORD2
reset	KEYWORD2
increment	KEYWORD2

series 	KEYWORD2
update	KEYWORD2
ready	KEYWORD2
get	KEYWORD2
sum	KEYWORD2
average	KEYWORD2
change	KEYWORD2
averageChange	KEYWORD2

measurement 	KEYWORD2
getValue	KEYWORD2
updated	KEYWORD2

sensor	KEYWORD2
readValue	KEYWORD2
readAnalog	KEYWORD2
readDigital	KEYWORD2

voltageSensor	KEYWORD2

temperatureSensor	KEYWORD2
setMode	KEYWORD2

hallEffectSensor 	KEYWORD2
touched	KEYWORD2
on	KEYWORD2

wheelSensor 	KEYWORD2
passed	KEYWORD2
ticks	KEYWORD2
revolutions	KEYWORD2

photoSensor 	KEYWORD2

switchSensor 	KEYWORD2
waitForOn	KEYWORD2
waitForOff	KEYWORD2

actuator 	KEYWORD2
writeAnalog	KEYWORD2
writeDigital	KEYWORD2

motorActuator 	KEYWORD2
start 	KEYWORD2
stop 	KEYWORD2

display	KEYWORD2
sendBluetooth	KEYWORD2
sendSD	KEYWORD2

#######################################
# Constants (LITERAL1)
#######################################
MODE_C LITERAL1
MODE_F LITERAL1

